################################################################################
#..........##.......##.....##....##.......##.......##.....##......##....##.....#
#..........##.......##.....##....##.......##.......##.....##......##....##.....#
#..........##..............##....##.......##............................##.....#
#..........##.......##.....##....##.......##.......##.....##......##....##.....#
#..........##.......##.....##....##................##.....##......##.......##.##
#..........##.......##.....##....##........#.......##......#......##....#####.##
#..........##.......##.....##....#########.###############.#########....##.....#
#..........##.......##.....##....#########.###############.#########....##.....#
#...................##...........##......#.........##.......##....##....##.....#
#############.#####################......##........##.......##....##....##.....#
#############.#####################................##.......##....##....##.....#
#.....##.......##.......##.......##......##........##.......##....##....##.....#
#.....##.......##.......##.......##......##........##.......##....##....######.#
#.....##.......##.......##...............##........##.............##....######.#
#.....##.......##.......##.......###############.###################....##.....#
#.....##................##.......###############.###################....##.....#
#.....##.......##.......##.......##....................##.........##....##.....#
#.....##.......##.......##.......##........##..........##.........##....##.....#
#..............##................##........##..........##.........##....##.....#
######.############################........##..........##.........##....######.#
######.############################........##..........##.........##....######.#
#....#..........##........##.....##........##..........##.........##....##.....#
#....##.........##........##.....##........##..........##.........##....##.....#
#....##.........##........##.....##........##..........##.........##....##.....#
#....##.........##........##.....##........##..........##.........##....##.....#
#....##.........##........##.....##........##.....................##....##.....#
#....##.........##...............###.###############################....##.....#
#....##...................##.....###.###############################....##.....#
#....##.........##........##.....##........##......##......##.....##....#......#
#....##########.##........##.....##........##......##......##.....#######.######
#....##########.##........##.....##........##......##......##.....#######.######
#....##.........##........###.#####................##......##.....##......#....#
#....##.........##........###.#####........##......##......##.....##...........#
#....##.........##........##.....##........##......##.............##.....##....#
#....##.........##........##.....##........##......##......##.....##.....##....#
#...............##........##.....##........##......##......##.....##.....##....#
#....##.........##........##.....#########.##......##......##.....##.....##....#
#....##.........##.........#.....#########.##......######.###.....##.....##....#
##########################.########........##.........###.###.....##.....##....#
##########################.########........##......##......##.....##.....##....#
#......##........##......#.......##........##......##......##.....##.....##....#
#......##........##......##......##........##......##......##.....##.....##....#
#......##........##..............##........##......##......##.....##.....##....#
#......##........##......##......##........##......##......##.....##.....##....#
#......##........##......##......##........##......##......##.....##.....##....#
#......##........##......##......##........##......##......##.....##.....##....#
#......##........##......##......##........##......#######.##.....##.....##....#
#......##........##......##......##........##......#######.##.....##.....##....#
#......##........##########.#######........##......##......##.....##.....##....#
#......##........##########.#######........##......##......##.....##.....##....#
#................##......##......#########.##########......##.....##.....##....#
#......##........##......##......#########.##########......##.....##.....##....#
#......##................##......##..........##....##......##.....##.######....#
#......##........##......##......##................##......##.....##.######....#
#......##........##......##......##..........##....##......##.....##.....##....#
#......##........##......##......##..........##....##......##.....##.....##....#
#......##........##......##......##..........##....##......##.....##.....##....#
#......##........##..............##..........##....##......##.....##.....##....#
#########################################################.######################
#########################################################.######################
#....##....##.......##.....##.....##....##.....##....##......##................#
#....##....##.......##.....##.....##....##.....##....##......##.........##.....#
#....##....##.......##.....##.....##....##.....##............##.........##.....#
#....##....##.......##.....##.....##....##...........##......##.........##.....#
##.####.............##.....##.....#####.##.....###########.####.........##.....#
##.####....##.......##.....###.########.##.....###########.####.........##.....#
#....##....##.......##.....###.#####....##.....##......##....##.........##.....#
#....#####.###########.....##.....##....##.....##......##....##.........##.....#
#....#####.############.#####.....##....##.....##......##....##.........##.....#
#....##.............###.#####.....##...........##......##....##.........##.....#
#....##.......##....##.....##...........##.....##......##....##.........##.....#
#....##.......##....##.....##.....##....##.....##............##.........##.....#
#....##.......##....##.....##.....##....##.....##......##....##.........##.....#
#....###.#######....##.....##.....##.#####.....##......##....##.........##.....#
#....###.#######....##.....######.##.######.#####......##....##.........##.....#
#....##.......##....##.....######.##....###.#####......##....##.........##.....#
#....##.......##....##.....##.....##....##.....##......##....##.........##.....#
#....##.......##....##.....##.....##....##.....##......##....##.........##.....#
#....##.......##....##.....##.....##....##.....##......##....##.........##.....#
#....##.......##...........##.....##....##.....##......##....##.........##.....#
#....######.##########.....##.....##....##.....##......##....##.........##.....#
#.......###.##########.....##.....##....##.....##......##....##.........##.....#
#....##.............##.....##.....##....##.....##......##...............##.....#
#....##......##.....##.....##.....##....##.....###########.####.........##.....#
#....##......##.....##.....##.....##....##.....###########.####.........##.....#
#....##......##.....##.....##.....##....##.....##.....##.....##.........##.....#
######################.######.....##....##.....##.....##.....##.........##.....#
######################.######.....##....##.....##.....##.....##.........##.....#
#.....##..........##.......##.....####.###.....##............##.........##.....#
#.....##..........##.......##.....####.###.....##.....##.....##.........##.....#
#.....##..........##.......##.....##....##.....##########.#####.........##.....#
#.....##...................##.....##....##.....##########.#####.........##.....#
#.....##..........##.......##.....##....##.....##......##....##.........##.....#
#.....##..........##.......##.....##....##.....##......##....##.........##.....#
#.................##.......##.....##....##.....##......##....##.........##.....#
#.....##..........##.......##.....##....##.....##............##.........##.....#
#.....##..........##.......##.....##....##.....##......##....##.........##.....#
#####################.##############################.#####################.....#
#####################.##############################.#####################.....#
#....##......##.....#......##........##............#.........##.........##.....#
#....##......##.....##.....##........##......##....##........##.........##.....#
#....##......##............##........##......##.........................##.....#
#............##.....##.....##................##....##........##.........#......#
##########.####......#.....##############################################.######
##########.#########.####################################################.######
#.....##.....#######.########....##....##....................##................#
#............##......##....##....##....##........##..........##......##........#
#.....##.....##......##....##....##....##........##..........##......##........#
#.....##.....##............##....##..............##..................##........#
#.....##.....##......##....##.......##########.#################################
#.....##.....##......##....##....#############.#################################
#.....##.....####.###########....##.......##........##...............##........#
#.###############.###########....##.......##........##....##.........##........#
#.#############............##....##.......##........##....##...................#
#.....##.....##......##....##....##.......##........##....##.........##........#
#.....##.............##....##....##.......##..............##.........##........#
#............##......##....##....##.................##....##.........##........#
#.....##.....##......##..........##.......##........##....##.........##........#
################################################################################
