################################################################################
#.............##..............##....##.....##......##....##...........##.......#
#.....##......##.....##.......##....##.....##......##....##....##.....##.......#
#.....##......##.....##.......##...........##......##....##....##.....##.......#
#.....##.............##.......##....##.....##......##....##....##.....##.......#
###################.############....##.....##......##....##....##.....##.......#
###################.############....#......##......##....##.############.......#
#.....................##......#######.#######.#######....##.############.......#
#......##......##.....##.........####.#######.####..............##....##.......#
#......##......##.....##......##....#......##......##....##...........##.......#
#......##......##.....##......##...................##....##.....##....##.......#
#......##......##.....##......##....##.....##......##....##.....##....##.......#
#......##......##.....##......##....##.....##......##....##.....##....##.......#
#......##......##.....##......#######################.##################.......#
#......##......##.............#######################.##################.......#
#......##......##.....##......##.....##.......##.........##.....##....##.......#
######.#########################.....##.......##.........##.....##....##.......#
######.#########################.....##.......##.........##...........##.......#
#......#.....##...............##.....##.......##................##....##.......#
#.....##...........##.........##.....##.......##.........##.....##....##.......#
#............##....##.........##.........................#......##....##.......#
#.....##.....##....##.........############################.#############.......#
########.############.........############################.#############.......#
########.############.........##....##..........##......##.....##.....##.......#
#....##.....##.....##.........##....##..................##.....##.....##.......#
#....##............##.........##....##..........##......##.....##.....##.......#
#...........##.....##.........##....##..........##.............##.....##.......#
#....##.....##.....##.........##....##..........##......##.....##.....##.......#
#....##.....##.....##.........##................##......##............##.......#
##.#####################################################################.......#
##.#####################################################################.......#
#......................##......##.....##....##....##...........##.....##.......#
#.....##.........##....##......##.....##....##...........##....##.....##.......#
#.....##.........##....##......##.....##....##....##.....##....##.....##.......#
#.....##.........##....##......##.................##.....##...........##.......#
#.....##.........##....##......##.....##....##....##.....##....##.....##.......#
#.....##.........##...................##....##....##.....##....##.....##.......#
############.###########################################################.......#
############.###########################################################.......#
#......##.......##.............##....##.........##....................##.......#
#......##.............##.......##....##.........##.........##.........##.......#
#......##.......##....##.......##....##.........##.........##.........##.......#
#......##.......##....##.......##....##.........##.........##.........##.......#
#......##.......##....##.............##.........##.........##.........##.......#
#...............##....##.......##....##.........##.........##..................#
##################.####################.#######################.########.......#
##################.####################.#######################.########.......#
#..........##.......##......##.......##.........##........##..........##.......#
#...................##......##.......##.........##........##..........##.......#
#..........##.......##......##.......##.........##........##..........##.......#
#..........##.......##......##.......##.........##........##..........##.......#
#..........##........................##...............................##.......#
#..........##.......#.......##.......################.##################.......#
#####################.##############....#############.##################.......#
#####################.#################.......##....#.......##........##.......#
#.....##..............##......##.....##.......##............##........##.......#
#.....##.......##.....##......##.....##.......##....##......##........##.......#
#.....##.......##.....##.............##.......##....##......##........##.......#
#..............##.............##.....##.............##................##.......#
################################################################################
################################################################################
#.....##......##.......##.....##.....##........##........##..........##........#
#.....##......##.......##.....##.....##..................##..........##........#
#.....##......##.......##.....##.....##........##........##..........##........#
#.....##......##.....................##........##........##..........##........#
#.....##......##.......##.....##.....##........##....................##........#
#.....##......##.......##.....##.....##........##........##..........##........#
#.............##.......##.....##.....##........##........##....................#
#.....##...............##.....##...............##........##..........##........#
##########.#####################################################################
##########.#####################################################################
#....##.....##....##.....##......##....##.....##..........##.............##....#
#...........##....##.....##......##....##.....##................##.......##....#
#....##.....##....##.....##......##...........##..........##....##.......##....#
#....##.....##....##.....##......##....##.....##..........##....##.......##....#
#....##...........##.....##......##....##.................##....##.............#
#....##.....##...........##............##.....##..........##....##.......##....#
#....##.....##....##.....##......##....##.....##..........##....##.......##....#
#....##.....##....##.............##....##.....##..........##....##.......##....#
#....##.....##....##.....##......##....##.....##..........##....##.......##....#
#########.######################################################################
#########.######################################################################
#....##............##.....##.......##........##.......##......##.........##....#
#....##......##....##.....##.......##........##.......##......##.........##....#
#....##......##....##.....##.......##........##...............##.........##....#
#....##......##....##.....##.......##........##.......##......##.........##....#
#....##......##....##.....##.......##.................##......##.........##....#
#............##...........##.......##........##.......##......##.........##....#
#....##......##....##........................##.......##.................##....#
#....##......##....##.....##.......##........##.......##......##...............#
#....##......##....##.....##.......##........##.......##......##.........##....#
###############.################################################################
###############.################################################################
#....##.............##...........##....##....##.........##.........##..........#
#....##.....##............##.................##.........##.........##..........#
#....##.....##......##....##.....##....##...............##.........##..........#
#....##.....##......##....##.....##....##....##.........##.........##..........#
#...........##......##....##.....##....##....##.........##.........##..........#
##################.##############################.########.....................#
##################.##############################.########.........##..........#
#.............##....##........##........##......#.......##.........##..........#
#....##.......##....##........##................##.................##..........#
#....##.......##....##..................##..............##.........##..........#
#....##.......##....##........##........##......##......##.........##..........#
#....##.............##........##........##......##......##.........##..........#
##############################################################################.#
##############################################################################.#
#..................##........##......##....##.......##..........##....##.......#
#........##........##........##......##....##.......##..........##.............#
#........##........##........##......##....##...................##....##.......#
#........##........##........##......##....##.......##................##.......#
##.########........##........##......##.............##..........##....##.......#
##.########........######.#####......############.##############################
#........##........######.#####......############.##############################
#........##........##........##......##......##..............##.........##.....#
#........##........##........##......##..............##........................#
#........##........##................##......##......##......##.........##.....#
#........##..................##..............##......##......##.........##.....#
#........##........##........##......##......##......##......##.........##.....#
################################################################################
